OOOOOOOOOOOOOOO
O O           O
O OOOOOO OOOO O
O      O   O  O
O OOOO OOO O OO
O O  O     O  O
O O  OOOOOOOO O
O O      O O  O
O OOOOOO O   OO
O        O     
O OOOOOO OOOOOO
O O      O    O
O OOOO O OOOO O
O      O      O
OOOOOOOOOOOOOOO